1 1 1 1 1 1 1 1 1 1
1 s 1 0 1 a 1 0 0 1
1 0 1 h 0 0 1 0 1 1
1 0 1 0 1 1 1 0 1 1
1 0 f d 1 0 0 0 0 1
1 g 1 0 1 0 1 1 1 1
1 0 1 1 1 0 1 e 0 1
1 c 1 0 b 0 1 1 0 1
1 0 i 0 1 0 0 0 0 1
1 1 1 1 1 1 1 1 1 1